28 36 36 36 36 36 36 36 36 36 36 36 36 36 36 36 36 36 36 36 36 36
28 0 0 0 0 0 0 0 0 0 0 0 0 0 0 0 0 0 0 0 0 14
28 0 0 0 0 0 0 0 0 0 0 0 0 0 0 0 0 0 0 0 0 14
28 0 0 0 0 0 0 0 0 0 0 0 0 0 0 0 0 0 0 0 0 14
28 0 0 0 0 0 0 0 0 0 0 0 0 0 0 0 0 0 0 0 0 14
28 0 0 0 0 0 0 0 0 0 0 0 0 0 0 0 0 0 0 0 0 14
28 0 0 0 0 0 0 0 0 0 0 0 0 0 0 0 0 0 0 0 0 14
28 0 0 0 0 0 0 0 0 0 0 0 0 0 0 0 0 0 0 0 0 14
28 0 0 0 0 0 0 0 0 0 0 0 0 0 0 0 0 0 0 0 0 14
28 0 0 0 0 0 0 0 0 0 0 0 0 0 0 0 0 0 0 0 0 14
28 0 0 0 0 0 0 0 0 0 0 0 0 0 0 0 0 0 0 0 0 14
28 0 0 0 0 0 0 0 0 0 0 0 0 0 0 0 0 0 0 0 0 14
28 0 0 0 0 0 0 0 0 0 0 0 0 0 0 0 0 0 0 0 0 14
36 36  36  36  36  36  36  36  36  36  36  36  36  36  36  36  36  36  36  36  36  36