2 2 2 2 2 2 2 2 2 2 2 2 2 2 2 2 2 2 2 2 2 2 2 2
2 28 36 36 36 36 36 36 36 36 36 36 36 36 36 36 36 36 36 36 36 36 36 2
2 28 0 0 0 0 0 0 0 0 0 0 0 0 0 0 0 0 0 0 0 0 14 2
2 28 0 0 0 0 0 0 0 0 0 0 0 0 0 0 0 0 0 0 0 0 14 2
2 28 0 0 0 0 0 0 0 0 0 0 0 0 0 0 0 0 0 0 0 0 14 2
2 28 0 0 0 0 0 0 0 0 0 0 0 0 0 0 0 0 0 0 0 0 14 2
2 28 0 0 0 0 0 0 0 0 0 0 0 0 0 0 0 0 0 0 0 0 14 2
2 28 0 0 0 0 0 0 0 0 0 0 36 36 0 0 0 0 0 0 0 0 14 2
2 28 0 0 0 0 0 0 0 0 0 0 0 0 0 0 0 0 0 0 0 0 14 2
2 28 0 0 0 0 0 0 0 0 0 0 0 0 0 0 0 0 0 0 0 0 14 2
2 28 0 0 0 0 0 0 0 0 0 0 0 0 0 0 0 0 0 0 0 0 14 2
2 28 0 0 0 0 0 0 0 0 0 0 0 0 0 0 0 0 0 0 0 0 14 2
2 28 0 0 0 0 0 0 0 0 0 0 0 0 0 0 0 0 0 0 0 0 14 2
2 28 0 0 0 0 0 0 0 0 0 0 0 0 0 0 0 0 0 0 0 0 14 2
2 36 36 36 36 36 36 36 36 36 36 36 36 36 36 36 36 36 36 36 36 36 36 2
2 2 2 2 2 2 2 2 2 2 2 2 2 2 2 2 2 2 2 2 2 2 2 2